10
10
E....ppppp
p....p...p
pp...p...p
.p...p...p
.p...p...p
.p...p...p
.p...p...p
.p...p...p
.p...p...p
.ppppp...S
